abysse=région très profonde
affectionner de haut en bas=affectionner contre, embrasser
agora=place publique
agreste=champêtre, sauvage
alabastre=récipient d'albâtre, poterie pour parfum ou huile
alala=crie de guerre
amarante=fleur infletrissable, qui ne fane pas
amarantine=d'amarante
apographe=copie d'un écrit, transcription
apostasie=action de s'éloigner de
apostat=qui fait acte d'apostasie
appâter=apatao, séduire
appât=apate, séduction
araire=charrue simple de type primitif sans avant-train et sans roues
assarion=assarius, as, monnaie de bronze ou de cuivre de la Rome antique

bivouaquer=passer la nuit en plein air, camper en plein air (dans la cour)
byssine=fait de byssus
byssus=genre de lin très fin, tissu précieux, batiste

calame=kalamos, calamus, roseau taillé pour écrire
catastropher=tourner de haut en bas
cens=census, recensement, redevance, impôt
chauler=couvrir de la chaux, plâtrer, blanchir à la chaux
chiton=vêtement de dessous sur peau
chlamyde=manteau retenu au cou par une agrafe
consacrement=en consécration
couffin=panier, corbeille (de paille tressée)

dème=division administrative et politique, district
denier=denarius, monnaie (romaine valant dix as)
dermique=qui a rapport au derme, de peau
despote=maître de maison, qui gouverne avec autorité absolue et arbitraire
despotiser=faire despote
dichotomiser=couper en deux

écoumène=terre habitée, ensemble des terres anthropisées
épanorthose=redresser droit de bas en haut au dessus
épigraphe=inscription au-dessus, écriture au-dessus
ère=aiôn, éon
être humain=anthropos
évergésie=action bien, bienfaisance
évergète=bien en action, bienfaiteur

fretin=opsarion, petite garniture, petit poisson
fureur=thumos, âme en fumée, souffle colérique

gouvernement=hégémonie

Hellénique=en langage grec
Helléniste=personne qui utilise la langue Grec
hérésie=airesis, action de prendre, choix, opinion, parti
himation=vêtement sans manches enroulé sur corps ou sur chiton, pallium
humain=anthropinos

iaspe=jaspe
icône=image
idolothyte=sacrifié à l'idole
Iérapolis=Hiérapolis
Ierosoluma=Jérusalem
Ierousalem=Jérusalem
Ierosolumites=Jérusalémites
inintelliger=ne pas intelliger
insomnie=agrypnie, sans sommeil
Ioudaia=Judée
Ioudaien=Judéen
Ioudaienne=Judéenne
Ioudaiques=Judaïques
Ioudaiquement=Judaïquement
Ioudaisme=Judaïsme
ioudaizer=judaïser


Kaesareia=Césarée

latrine=aphedron, outil pour asseoir au loin

muid=modius, récipient de mesure, boisseau

nard liquide=nard de ( croyance, confiance, fidèle, potable, buvable)
nomisma=pièce de monnaie

oliban=encens
onguent=baume, pommade, huile parfumé, myrrhe
Ouai=Oy Vaï, hélas, malheur, interjection hébraïque


Pantocrator=Tout Puissant, Maître de tout, qui règne tout
phantasme=apparition, vision, fantôme
plénitude=plérôme, complétude, plein
pornation=du porno
porner=faire du porno

pourpre=porphyre, violet

retournement de bas en haut=anastrophe, conversion complète
rétribution=antapodose, don en échange
rhomphaia=puissante épée
royalique=relatif au royal, qui est propre au royal

sans levain=azyme
saton=mesure grecque d’environ 14 litres
schisme=division, séparation, scission, déchirure
senne=filet de pêche encerclant
sérique=de soie
sinapis=Sinapis (alba, arvensis, ...)
sindon=fin tissu en lin, pour se coucher, ensevelir les morts
spirale=spire, enroulement, corps enroulé, cohorte
spolier=priver au loin, dépouiller au loin

temporiser=prendre du temps, retarder, en attente
thrène=lamentation funèbre, chant funèbre
transintelligence=metanoia, au-delà de l'intelligence, changement d'intelligence, transcendance de l'intellect
transintelliger=metanoeo, intelliger au-delà, changer l'intelligence, transcender l'intellect